#############
#...........#
#...........#
#...........#
#....####...#
#....####...#
#############
