#############
#....##.....#
#....##.....#
#...........#
#....####...#
#....####...#
#############
